"aA" = (/obj/machinery/portable_atmospherics/canister/nitrophoric_oxide,/obj/item/tank/phoroanesthetic,/turf/simulated/shuttle/floor/alienplating/blue{oxygen = 0; phoron = 21.8366},/area/submap/outpost21/structure_generic/alienshipa)
"aM" = (/obj/structure/meteorite,/turf/simulated/shuttle/floor/alienplating/vacuum,/area/submap/outpost21/structure_generic/alienshipa)
"aP" = (/obj/machinery/chemical_dispenser/ert/specialops/abductor{dir = 1},/turf/simulated/shuttle/floor/alienplating/blue{oxygen = 0; phoron = 21.8366},/area/submap/outpost21/structure_generic/alienshipa)
"bi" = (/obj/structure/table/alien/blue,/obj/item/prop/alien/junk,/obj/item/prop/alien/junk,/obj/item/prop/alien/junk,/obj/item/prop/alien/junk,/obj/item/prop/alien/junk,/obj/item/prop/alien/junk,/turf/simulated/shuttle/floor/alienplating/blue{oxygen = 0; phoron = 21.8366},/area/submap/outpost21/structure_generic/alienshipa)
"ck" = (/obj/structure/prop/dominator/purple,/turf/simulated/shuttle/floor/alienplating/blue{oxygen = 0; phoron = 21.8366},/area/submap/outpost21/structure_generic/alienshipa)
"cr" = (/obj/item/prop/alien/junk,/turf/simulated/shuttle/floor/alienplating/blue{oxygen = 0; phoron = 21.8366},/area/submap/outpost21/structure_generic/alienshipa)
"cN" = (/obj/item/prop/alien/junk,/turf/simulated/shuttle/floor/alienplating/vacuum,/area/submap/outpost21/structure_generic/alienshipa)
"cV" = (/obj/machinery/ion_engine{dir = 4},/turf/simulated/shuttle/floor/alienplating/vacuum,/area/submap/outpost21/structure_generic/alienshipa)
"dp" = (/obj/structure/loot_pile/surface/alien,/turf/simulated/shuttle/floor/alienplating/vacuum,/area/submap/outpost21/structure_generic/alienshipa)
"dF" = (/obj/structure/table/alien/blue,/obj/item/surgical/FixOVein/alien,/obj/item/surgical/surgicaldrill/alien{pixel_y = -7},/turf/simulated/shuttle/floor/alienplating/blue{oxygen = 0; phoron = 21.8366},/area/submap/outpost21/structure_generic/alienshipa)
"eA" = (/obj/structure/prop/dominator/blue,/turf/simulated/shuttle/floor/alienplating/blue{oxygen = 0; phoron = 21.8366},/area/submap/outpost21/structure_generic/alienshipa)
"fc" = (/obj/machinery/porta_turret/alien{check_all = 0; check_anomalies = 0; check_arrest = 0; check_records = 0},/turf/simulated/shuttle/floor/alienplating/vacuum,/area/submap/outpost21/structure_generic/alienshipa)
"ft" = (/obj/structure/lattice,/obj/structure/meteorite,/turf/space,/area/submap/outpost21/structure_generic/alienshipa)
"fX" = (/turf/simulated/shuttle/floor/alien/blue{oxygen = 0; phoron = 21.8366},/area/submap/outpost21/structure_generic/alienshipa)
"hH" = (/obj/structure/bed/alien,/mob/living/simple_mob/mechanical/cyber_horror/vox{ID_provided = 1; myid_access = list(300)},/turf/simulated/shuttle/floor/alienplating/blue{oxygen = 0; phoron = 21.8366},/area/submap/outpost21/structure_generic/alienshipa)
"kB" = (/obj/structure/prop/machine/conduit/starts_on,/turf/simulated/shuttle/floor/alienplating/blue{oxygen = 0; phoron = 21.8366},/area/submap/outpost21/structure_generic/alienshipa)
"kG" = (/obj/structure/bed/alien,/turf/simulated/shuttle/floor/alienplating/blue{oxygen = 0; phoron = 21.8366},/area/submap/outpost21/structure_generic/alienshipa)
"kK" = (/turf/simulated/shuttle/wall/alien/hard_corner,/area/submap/outpost21/structure_generic/alienshipa)
"lx" = (/obj/structure/table/alien/blue,/obj/item/prop/alien/junk,/turf/simulated/shuttle/floor/alienplating/blue{oxygen = 0; phoron = 21.8366},/area/submap/outpost21/structure_generic/alienshipa)
"lO" = (/obj/item/gun/energy/medigun,/obj/structure/table/alien/blue,/obj/item/storage/belt/medical/alien,/obj/item/storage/belt/medical/alien,/turf/simulated/shuttle/floor/alien/blue{oxygen = 0; phoron = 21.8366},/area/submap/outpost21/structure_generic/alienshipa)
"mv" = (/obj/structure/prop/alien/pod,/turf/simulated/shuttle/floor/alienplating/blue{oxygen = 0; phoron = 21.8366},/area/submap/outpost21/structure_generic/alienshipa)
"ne" = (/obj/structure/prop/dominator/orange,/turf/simulated/shuttle/floor/alienplating/blue{oxygen = 0; phoron = 21.8366},/area/submap/outpost21/structure_generic/alienshipa)
"nS" = (/obj/structure/loot_pile/surface/alien/engineering,/turf/simulated/shuttle/floor/alienplating/blue{oxygen = 0; phoron = 21.8366},/area/submap/outpost21/structure_generic/alienshipa)
"ot" = (/obj/structure/prop/dominator/red,/turf/simulated/shuttle/floor/alienplating/blue{oxygen = 0; phoron = 21.8366},/area/submap/outpost21/structure_generic/alienshipa)
"oD" = (/obj/structure/closet/alien,/turf/simulated/shuttle/floor/alienplating/blue{oxygen = 0; phoron = 21.8366},/area/submap/outpost21/structure_generic/alienshipa)
"pE" = (/obj/machinery/door/airlock/alien/blue/public{name = "alien airlock"; req_one_access = list(801)},/turf/simulated/shuttle/floor/alienplating/blue{oxygen = 0; phoron = 21.8366},/area/submap/outpost21/structure_generic/alienshipa)
"qv" = (/turf/simulated/shuttle/wall/alien,/area/submap/outpost21/structure_generic/alienshipa)
"qO" = (/obj/structure/table/alien/blue,/obj/item/prop/alien/junk,/obj/item/prop/alien/junk,/obj/item/prop/alien/junk,/obj/item/prop/alien/junk,/obj/item/prop/alien/junk,/obj/item/prop/alien/junk,/obj/item/prop/alien/junk,/obj/item/prop/alien/junk,/obj/item/prop/alien/junk,/obj/item/prop/alien/junk,/turf/simulated/shuttle/floor/alienplating/blue{oxygen = 0; phoron = 21.8366},/area/submap/outpost21/structure_generic/alienshipa)
"ra" = (/obj/structure/table/alien,/obj/structure/prop/prismcontrol,/turf/simulated/shuttle/floor/alienplating/blue{oxygen = 0; phoron = 21.8366},/area/submap/outpost21/structure_generic/alienshipa)
"rU" = (/obj/structure/table/alien/blue,/obj/item/prop/alien/junk,/obj/item/prop/alien/junk,/obj/item/prop/alien/junk,/obj/item/prop/alien/junk,/obj/item/prop/alien/junk,/obj/item/prop/alien/junk,/obj/item/prop/alien/junk,/obj/item/prop/alien/junk,/turf/simulated/shuttle/floor/alienplating/blue{oxygen = 0; phoron = 21.8366},/area/submap/outpost21/structure_generic/alienshipa)
"sz" = (/obj/structure/table/alien/blue,/obj/item/surgical/bone_clamp/alien{pixel_y = -6},/obj/item/surgical/circular_saw/alien{pixel_y = 6},/turf/simulated/shuttle/floor/alien/blue{oxygen = 0; phoron = 21.8366},/area/submap/outpost21/structure_generic/alienshipa)
"tg" = (/obj/machinery/door/airlock/alien/blue/public{name = "alien airlock"; req_one_access = list(803)},/turf/simulated/shuttle/floor/alienplating/blue{oxygen = 0; phoron = 21.8366},/area/submap/outpost21/structure_generic/alienshipa)
"ub" = (/obj/structure/table/alien/blue,/obj/item/roller/adv,/turf/simulated/shuttle/floor/alienplating/blue{oxygen = 0; phoron = 21.8366},/area/submap/outpost21/structure_generic/alienshipa)
"ut" = (/obj/structure/table/alien/blue,/obj/random/greaterportalloot,/obj/random/greaterportalloot,/obj/random/greaterportalloot,/turf/simulated/shuttle/floor/alienplating/blue{oxygen = 0; phoron = 21.8366},/area/submap/outpost21/structure_generic/alienshipa)
"uE" = (/mob/living/simple_mob/mechanical/cyber_horror/vox{ID_provided = 1; myid_access = list(300)},/turf/simulated/shuttle/floor/alien/blue{oxygen = 0; phoron = 21.8366},/area/submap/outpost21/structure_generic/alienshipa)
"uG" = (/obj/machinery/door/airlock/alien/blue{name = "bridge"; req_one_access = list(802)},/turf/simulated/shuttle/floor/alienplating/blue{oxygen = 0; phoron = 21.8366},/area/submap/outpost21/structure_generic/alienshipa)
"vy" = (/obj/machinery/power/port_gen/large_altevian,/turf/simulated/shuttle/floor/alienplating/blue{oxygen = 0; phoron = 21.8366},/area/submap/outpost21/structure_generic/alienshipa)
"vC" = (/obj/item/vox/armalis_armour,/obj/item/vox/armalis_amp,/turf/simulated/shuttle/floor/alienplating/blue{oxygen = 0; phoron = 21.8366},/area/submap/outpost21/structure_generic/alienshipa)
"vE" = (/obj/structure/frame,/turf/simulated/shuttle/floor/alienplating/blue{oxygen = 0; phoron = 21.8366},/area/submap/outpost21/structure_generic/alienshipa)
"wh" = (/obj/machinery/replicator/vore,/turf/simulated/shuttle/floor/alienplating/blue{oxygen = 0; phoron = 21.8366},/area/submap/outpost21/structure_generic/alienshipa)
"wT" = (/obj/machinery/power/rtg/abductor/built,/turf/simulated/shuttle/floor/alienplating/blue{oxygen = 0; phoron = 21.8366},/area/submap/outpost21/structure_generic/alienshipa)
"yT" = (/obj/structure/meteorite,/obj/item/prop/alien/junk,/turf/simulated/shuttle/floor/alienplating/vacuum,/area/submap/outpost21/structure_generic/alienshipa)
"zk" = (/turf/simulated/shuttle/floor/alienplating/blue{oxygen = 0; phoron = 21.8366},/area/submap/outpost21/structure_generic/alienshipa)
"Au" = (/obj/structure/table/alien/blue,/obj/item/storage/firstaid/vox,/obj/item/storage/firstaid/vox,/obj/item/healthanalyzer/phasic{pixel_x = 7; pixel_y = 9},/turf/simulated/shuttle/floor/alienplating/blue{oxygen = 0; phoron = 21.8366},/area/submap/outpost21/structure_generic/alienshipa)
"BR" = (/obj/structure/table/alien/blue,/obj/item/card/id/keycard/blue,/turf/simulated/shuttle/floor/alienplating/blue{oxygen = 0; phoron = 21.8366},/area/submap/outpost21/structure_generic/alienshipa)
"CA" = (/obj/machinery/door/airlock/alien/blue/public{name = "alien airlock"},/turf/simulated/shuttle/floor/alien/blue{oxygen = 0; phoron = 21.8366},/area/submap/outpost21/structure_generic/alienshipa)
"Ec" = (/obj/structure/prop/alien/computer/camera{dir = 8},/turf/simulated/shuttle/floor/alienplating/blue{oxygen = 0; phoron = 21.8366},/area/submap/outpost21/structure_generic/alienshipa)
"Eo" = (/obj/structure/prop/machine/alien_tank,/turf/simulated/shuttle/floor/alienplating/blue{oxygen = 0; phoron = 21.8366},/area/submap/outpost21/structure_generic/alienshipa)
"Fh" = (/turf/simulated/shuttle/plating/airless,/area/submap/outpost21/structure_generic/alienshipa)
"Fi" = (/obj/structure/loot_pile/surface/alien/end,/turf/simulated/shuttle/floor/alienplating/blue{oxygen = 0; phoron = 21.8366},/area/submap/outpost21/structure_generic/alienshipa)
"FB" = (/obj/structure/table/alien/blue,/obj/item/surgical/cautery/alien,/obj/item/surgical/retractor/alien{pixel_y = -9},/obj/item/surgical/scalpel/alien{pixel_y = 8},/turf/simulated/shuttle/floor/alienplating/blue{oxygen = 0; phoron = 21.8366},/area/submap/outpost21/structure_generic/alienshipa)
"Gg" = (/obj/structure/fans/hardlight/colorable/abductor,/obj/machinery/door/airlock/alien/blue{name = "Exterior"; req_one_access = list(801)},/obj/effect/mine/dnascramble{camo_net = 1},/turf/simulated/shuttle/floor/alienplating/blue{oxygen = 0; phoron = 21.8366},/area/submap/outpost21/structure_generic/alienshipa)
"Iu" = (/obj/structure/lattice,/turf/space,/area/submap/outpost21/structure_generic/alienshipa)
"Iv" = (/turf/space,/area/space)
"Jn" = (/obj/structure/table/alien,/obj/item/clothing/accessory/medal/dungeon/alien_ufo,/turf/simulated/shuttle/floor/alienplating/blue{oxygen = 0; phoron = 21.8366},/area/submap/outpost21/structure_generic/alienshipa)
"Jz" = (/obj/machinery/door/airlock/alien/blue/public{name = "alien airlock"; req_one_access = list(803)},/turf/simulated/shuttle/floor/alien/blue{oxygen = 0; phoron = 21.8366},/area/submap/outpost21/structure_generic/alienshipa)
"JE" = (/obj/structure/fans/hardlight/colorable/abductor,/obj/machinery/door/airlock/alien/blue{name = "Exterior"; req_one_access = list(801)},/turf/simulated/shuttle/floor/alienplating/blue{oxygen = 0; phoron = 21.8366},/area/submap/outpost21/structure_generic/alienshipa)
"JL" = (/obj/structure/prop/dna_vault,/turf/simulated/shuttle/floor/alienplating/blue{oxygen = 0; phoron = 21.8366},/area/submap/outpost21/structure_generic/alienshipa)
"KD" = (/obj/structure/table/alien,/obj/item/prop/alien/junk,/obj/item/prop/alien/junk,/turf/simulated/shuttle/floor/alienplating/blue{oxygen = 0; phoron = 21.8366},/area/submap/outpost21/structure_generic/alienshipa)
"Le" = (/obj/structure/prop/machine/bsb_on,/turf/simulated/shuttle/floor/alienplating/blue{oxygen = 0; phoron = 21.8366},/area/submap/outpost21/structure_generic/alienshipa)
"LP" = (/obj/machinery/optable,/obj/machinery/oxygen_pump/phoroanesthetic{pixel_x = -32},/turf/simulated/shuttle/floor/alienplating/blue{oxygen = 0; phoron = 21.8366},/area/submap/outpost21/structure_generic/alienshipa)
"LT" = (/mob/living/simple_mob/mechanical/cyber_horror/vox{ID_provided = 1; myid_access = list(300)},/turf/simulated/shuttle/floor/alienplating/blue{oxygen = 0; phoron = 21.8366},/area/submap/outpost21/structure_generic/alienshipa)
"Mc" = (/obj/structure/loot_pile/surface/alien/security,/turf/simulated/shuttle/floor/alienplating/blue{oxygen = 0; phoron = 21.8366},/area/submap/outpost21/structure_generic/alienshipa)
"Nc" = (/obj/structure/window/phoronreinforced{dir = 8},/obj/structure/window/phoronreinforced{dir = 4},/turf/simulated/shuttle/floor/alienplating/vacuum,/area/submap/outpost21/structure_generic/alienshipa)
"NI" = (/obj/structure/window/phoronreinforced{dir = 8},/obj/structure/window/phoronreinforced{dir = 4},/obj/structure/window/phoronreinforced,/turf/simulated/shuttle/floor/alienplating/vacuum,/area/submap/outpost21/structure_generic/alienshipa)
"Ov" = (/obj/structure/table/alien/blue,/obj/machinery/artifact,/turf/simulated/shuttle/floor/alienplating/blue{oxygen = 0; phoron = 21.8366},/area/submap/outpost21/structure_generic/alienshipa)
"OY" = (/obj/effect/mine/claymore{dir = 8},/turf/simulated/shuttle/floor/alienplating/blue{oxygen = 0; phoron = 21.8366},/area/submap/outpost21/structure_generic/alienshipa)
"Pt" = (/obj/structure/table/alien/blue,/obj/item/storage/belt/utility/alien/full,/obj/item/storage/belt/utility/alien/full,/turf/simulated/shuttle/floor/alienplating/blue{oxygen = 0; phoron = 21.8366},/area/submap/outpost21/structure_generic/alienshipa)
"Px" = (/obj/machinery/sleeper/survival_pod,/turf/simulated/shuttle/floor/alien/blue{oxygen = 0; phoron = 21.8366},/area/submap/outpost21/structure_generic/alienshipa)
"PK" = (/obj/structure/table/alien/blue,/turf/simulated/shuttle/floor/alienplating/blue{oxygen = 0; phoron = 21.8366},/area/submap/outpost21/structure_generic/alienshipa)
"PS" = (/obj/machinery/porta_turret/alien{check_all = 0; check_anomalies = 0; check_arrest = 0; check_records = 0},/turf/simulated/shuttle/floor/alienplating/blue{oxygen = 0; phoron = 21.8366},/area/submap/outpost21/structure_generic/alienshipa)
"Qg" = (/turf/template_noop,/area/template_noop)
"QE" = (/obj/item/clothing/shoes/magboots/vox,/obj/item/clothing/under/vox/vox_casual,/obj/item/clothing/under/vox/vox_robes,/obj/item/tank/vox,/obj/item/clothing/mask/breath,/obj/structure/closet/alien,/obj/item/clothing/accessory/holster/leg/black,/obj/item/clothing/gloves/vox,/obj/item/card/id/keycard/green,/turf/simulated/shuttle/floor/alienplating/blue{oxygen = 0; phoron = 21.8366},/area/submap/outpost21/structure_generic/alienshipa)
"Rd" = (/obj/structure/meteorite,/turf/simulated/shuttle/plating/airless,/area/submap/outpost21/structure_generic/alienshipa)
"RB" = (/obj/structure/loot_pile/surface/alien/medical,/turf/simulated/shuttle/floor/alienplating/blue{oxygen = 0; phoron = 21.8366},/area/submap/outpost21/structure_generic/alienshipa)
"Sg" = (/obj/structure/prop/alien/computer{dir = 8},/turf/simulated/shuttle/floor/alienplating/blue{oxygen = 0; phoron = 21.8366},/area/submap/outpost21/structure_generic/alienshipa)
"St" = (/obj/machinery/door/airlock/alien/blue/public{name = "alien airlock"},/turf/simulated/shuttle/floor/alienplating/blue{oxygen = 0; phoron = 21.8366},/area/submap/outpost21/structure_generic/alienshipa)
"Td" = (/obj/structure/prop/alien/pod/open,/turf/simulated/shuttle/floor/alienplating/blue{oxygen = 0; phoron = 21.8366},/area/submap/outpost21/structure_generic/alienshipa)
"Vb" = (/obj/structure/prop/machine/core,/turf/simulated/shuttle/floor/alienplating/blue{oxygen = 0; phoron = 21.8366},/area/submap/outpost21/structure_generic/alienshipa)
"VL" = (/obj/structure/prop/machine/biosyphon,/obj/structure/table/alien/blue,/turf/simulated/shuttle/floor/alienplating/blue{oxygen = 0; phoron = 21.8366},/area/submap/outpost21/structure_generic/alienshipa)
"VX" = (/obj/item/card/id/keycard,/obj/item/digestion_remains/skull/vox,/mob/living/simple_mob/mechanical/cyber_horror/vox{ID_provided = 1; myid_access = list(300)},/turf/simulated/shuttle/floor/alienplating/blue{oxygen = 0; phoron = 21.8366},/area/submap/outpost21/structure_generic/alienshipa)
"We" = (/obj/structure/loot_pile/surface/alien,/turf/simulated/shuttle/floor/alienplating/blue{oxygen = 0; phoron = 21.8366},/area/submap/outpost21/structure_generic/alienshipa)
"Wh" = (/obj/effect/mine/emp/camo,/turf/simulated/shuttle/floor/alien/blue{oxygen = 0; phoron = 21.8366},/area/submap/outpost21/structure_generic/alienshipa)
"XK" = (/obj/structure/prop/machine/alien_tank/starts_broken,/turf/simulated/shuttle/floor/alienplating/blue{oxygen = 0; phoron = 21.8366},/area/submap/outpost21/structure_generic/alienshipa)
"Yb" = (/turf/simulated/shuttle/floor/alienplating/vacuum,/area/submap/outpost21/structure_generic/alienshipa)
"Ym" = (/obj/machinery/chemical_dispenser/ert/specialops/abductor,/turf/simulated/shuttle/floor/alienplating/blue{oxygen = 0; phoron = 21.8366},/area/submap/outpost21/structure_generic/alienshipa)
"Zp" = (/obj/structure/window/phoronreinforced{dir = 8},/obj/structure/window/phoronreinforced{dir = 4},/obj/structure/window/phoronreinforced{dir = 1},/turf/simulated/shuttle/floor/alienplating/vacuum,/area/submap/outpost21/structure_generic/alienshipa)
"ZB" = (/obj/structure/table/alien/blue,/obj/item/surgical/bioregen,/obj/item/surgical/bonegel,/turf/simulated/shuttle/floor/alien/blue{oxygen = 0; phoron = 21.8366},/area/submap/outpost21/structure_generic/alienshipa)
"ZI" = (/obj/structure/table/alien,/obj/item/toy/plushie/vox{name = "Iggy"},/turf/simulated/shuttle/floor/alienplating/blue{oxygen = 0; phoron = 21.8366},/area/submap/outpost21/structure_generic/alienshipa)

(1,1,1) = {"
QgQgQgQgQgQgQgQgQgQgQgQgQgQgQgQgQgQgQgQgQgQgQgQgQgQgQgQgQgQgQgQgQgQgQgQgQgQgQgQgQgQgQgQgQgQgQgQgQgQg
QgQgQgQgQgQgQgQgQgQgQgQgQgQgQgQgQgQgQgQgQgQgQgQgQgQgQgQgQgQgQgQgQgQgQgQgQgQgQgQgQgQgQgQgQgQgQgQgQgQg
QgQgQgQgQgQgQgQgQgQgQgQgQgQgQgQgQgQgQgQgQgQgQgQgQgQgQgQgQgQgQgQgQgQgQgQgQgQgQgQgQgQgQgQgQgQgQgQgQgQg
QgQgQgQgQgQgQgQgQgQgQgQgQgQgQgQgQgQgQgQgQgQgQgQgQgQgQgQgQgQgQgQgQgQgQgQgQgQgQgQgQgQgQgQgQgQgQgQgQgQg
QgQgQgQgQgQgQgQgQgQgQgQgQgQgQgQgQgQgQgQgQgQgQgQgQgQgQgQgQgQgQgQgQgQgQgQgQgQgQgQgQgQgQgQgQgQgQgQgQgQg
QgQgQgQgQgQgQgQgQgQgQgQgQgQgQgQgQgQgQgQgQgQgQgQgQgQgQgQgQgQgQgQgQgQgQgQgQgQgQgQgQgQgQgQgQgQgQgQgQgQg
QgQgQgQgQgQgQgQgQgQgQgQgQgQgQgQgQgQgQgQgQgQgQgQgQgQgQgQgQgQgQgQgQgQgQgQgQgQgQgQgQgQgQgQgQgQgQgQgQgQg
QgQgQgQgQgQgQgQgQgQgQgQgQgQgQgQgQgQgQgQgQgQgQgQgQgQgQgQgQgQgQgQgQgQgQgQgQgQgQgQgQgQgQgQgQgQgQgQgQgQg
QgIvIvIvIvIvIvIvIvIvIvIvIvIvIvIvIvIvQgQgQgQgQgQgQgQgQgQgQgQgQgQgQgQgQgQgQgQgQgQgQgQgQgQgQgQgQgQgQgQg
QgIvIvIvIvIvIvIvIvIvIvIvIvIvIvIvIvIvIvIvQgQgQgQgQgQgQgQgQgQgQgQgQgQgQgQgQgQgQgQgQgQgQgQgQgQgQgQgQgQg
QgqvqvqvqvqvqvqvqvqvqvqvqvqvqvIvIvIvIvIvIvIvQgQgQgQgQgQgQgQgQgQgQgQgQgQgQgQgQgQgQgQgQgQgQgQgQgQgQgQg
QgIvIvqvqvQEhHzkkKzkqvoDqvoDqvqvqvqvIvIvIvIvIvQgQgQgQgQgQgQgQgQgQgQgQgQgQgQgQgQgQgQgQgQgQgQgQgQgQgQg
QgIvIvIvqvqvzkzkpEzkqvkGqvkGqvqvqvqvqvIvIvIvIvIvQgQgQgQgQgQgQgQgQgQgQgQgQgQgQgQgQgQgQgQgQgQgQgQgQgQg
QgQgIvIvIvqvqvqvkKzkkKStkKStqvzkzkzkqvqvIvIvIvIvIvQgQgQgQgQgQgQgQgQgQgQgQgQgQgQgQgQgQgQgQgQgQgQgQgQg
QgQgQgIvIvIvqvqvPSzkzkzkzkzkqvzkuEzkqvqvqvIvIvIvIvIvQgQgQgQgQgQgQgQgQgQgQgQgQgQgQgQgQgQgQgQgQgQgQgQg
QgQgQgQgIvIvIvqvqvzkzkzkfXfXqvJLfXzkkKqvqvqvIvIvIvIvIvQgQgQgQgQgQgQgQgQgQgQgQgQgQgQgQgQgQgQgQgQgQgQg
QgQgQgQgQgIvIvIvqvqvqvqvqvCAqvckzkzkYmaPWeqvqvIvIvIvIvIvQgQgQgQgQgQgQgQgQgQgQgQgQgQgQgQgQgQgQgQgQgQg
QgQgQgQgQgIvIvIvIvqvzkzkfXfXCAfXzkzkzkzkzkzkqvqvIvIvIvIvIvIvIvIvIvIvIvIvIvIvIvIvIvIvQgQgQgQgQgQgQgQg
QgQgQgQgQgQgIvIvqvqvzkzkzkfXCAfXzkzkzkzkzkzkPSqvqvIvIvIvIvIvIvIvIvIvIvIvIvIvIvIvIvIvIvIvIvIvQgQgQgQg
QgQgQgQgQgQgIvIvqvPSzkzkqvqvqvqvqvqvqvqvqvqvqvqvqvqvqvqvqvqvqvqvqvqvqvqvqvqvqvqvIvIvIvIvIvIvIvIvQgQg
QgQgQgQgIvIvIvIvqvkKzkzkzkzkzkfXCAfXzkzkzkzkzkzkzkzkzkzkzkzkzkzkzkzkzkzkzkzkOYqvqvqvqvqvIvIvIvIvIvQg
QgQgQgIvIvIvIvIvIvJEzkzkzkzkzkfXCAfXzkzkzkzkzkzkzkzkzkzkzkzkzkzkzkzkzkzkzkzkzkzkPSqvPSqvqvqvqvIvIvQg
QgQgQgIvIvIvqvqvqvqvqvqvqvqvzkzkqvqvqvqvqvqvqvqvPSzkzkPSqvqvqvqvqvqvqvqvqvqvzkzkzkqvcrFiKDZIqvIvIvQg
QgQgQgIvIvqvqvzkzkkBnSwTwTqvzkzkqvEoEoXKVLvEOvqvqvzkzkqvqvnemvmvMcMcqOqOqOqvqvzkzkqvzkzkzkzkqvqvIvQg
QgQgQgIvIvcVZpvyzkzkzkzkWhkKfXzkqvzkzkzkzkzkzkfXqvfXfXqvfXzkzkzkzkzkzkzkzkPSqvzkfXqvfXzkzkzkEcqvIvQg
QgQgQgIvIvcVNczkzkzkLTLefXpEfXzkqvPSzkzkLTzkzkfXJzfXfXJzfXrUrUlxPKPKPKPKzkBRqvVXfXuGfXzkzkvCSgqvIvQg
QgQgQgIvIvcVNIzkzkzkzkzkfXkKfXzkqvzkzkzkzkzkzkfXqvfXfXqvfXzkzkzkzkzkzkzkzkPSqvzkfXqvfXzkzkzkSgqvIvQg
QgQgQgIvIvqvqvvyzkVbnSwTwTqvzkzkqvEoXKEoeAeAOvqvqvzkzkqvqvotTdwhMcMcututPtqvqvzkzkqvzkzkzkzkqvqvIvQg
QgQgQgIvIvIvqvqvqvqvqvqvqvqvzkzkqvqvqvqvqvqvqvqvPSzkzkPSqvqvqvqvqvqvqvqvqvqvzkzkzkqvzkFiraJnqvIvIvQg
QgQgQgIvIvIvIvIvIvGgzkzkzkzkzkfXCAfXzkzkzkzkzkzkzkzkzkzkzkzkzkzkzkzkzkzkzkzkzkzkPSqvPSqvqvqvqvIvIvQg
QgQgQgQgIvIvIvIvqvkKzkzkzkzkzkfXCAfXzkzkzkzkzkzkzkzkzkzkzkzkzkzkzkzkzkzkzkzkOYqvqvqvqvqvIvIvIvIvIvQg
QgQgQgQgQgQgIvIvqvPSzkzkqvqvqvqvqvqvqvqvqvqvqvqvqvqvqvqvqvqvqvqvqvqvqvqvqvqvqvqvIvIvIvIvIvIvIvIvQgQg
QgQgQgQgQgQgIvIvqvqvzkzkzkfXCAYbYbFhaMYbYbFhfcqvqvIvIvIvIvIvIvIvIvIvIvIvIvIvIvIvIvIvIvIvIvIvQgQgQgQg
QgQgQgQgQgIvIvIvIvqvzkzkfXfXCAYbyTcNYbYbYbYbqvqvIvIvIvIvIvIvIvIvIvIvIvIvIvIvIvIvIvIvQgQgQgQgQgQgQgQg
QgQgQgQgQgIvIvIvqvqvqvqvqvtgqvYbcNFhftYbFhFhIuIvIvIvIvIvQgQgQgQgQgQgQgQgQgQgQgQgQgQgQgQgQgQgQgQgQgQg
QgQgQgQgIvIvIvqvqvPxzkzkfXfXqvcNRdYbYbYbIuIvIvIvIvIvIvQgQgQgQgQgQgQgQgQgQgQgQgQgQgQgQgQgQgQgQgQgQgQg
QgQgQgIvIvIvqvqvAuzkzkzkLTzkqvcNYbYbRdIuIvIvIvIvIvIvQgQgQgQgQgQgQgQgQgQgQgQgQgQgQgQgQgQgQgQgQgQgQgQg
QgQgIvIvIvqvqvLPzkzkRBRBzkzkqvYbFhYbIuIvIvIvIvIvIvQgQgQgQgQgQgQgQgQgQgQgQgQgQgQgQgQgQgQgQgQgQgQgQgQg
QgIvIvIvqvqvbizkzkzkzkzkzklOqvdpYbqvqvIvIvIvIvIvQgQgQgQgQgQgQgQgQgQgQgQgQgQgQgQgQgQgQgQgQgQgQgQgQgQg
QgIvIvqvqvaAzkzkdFFBszubzkZBqvqvqvqvIvIvIvIvIvQgQgQgQgQgQgQgQgQgQgQgQgQgQgQgQgQgQgQgQgQgQgQgQgQgQgQg
QgqvqvqvqvqvqvqvqvqvqvqvqvqvqvIvIvIvIvIvIvIvQgQgQgQgQgQgQgQgQgQgQgQgQgQgQgQgQgQgQgQgQgQgQgQgQgQgQgQg
QgIvIvIvIvIvIvIvIvIvIvIvIvIvIvIvIvIvIvIvQgQgQgQgQgQgQgQgQgQgQgQgQgQgQgQgQgQgQgQgQgQgQgQgQgQgQgQgQgQg
QgIvIvIvIvIvIvIvIvIvIvIvIvIvIvIvIvIvQgQgQgQgQgQgQgQgQgQgQgQgQgQgQgQgQgQgQgQgQgQgQgQgQgQgQgQgQgQgQgQg
QgQgQgQgQgQgQgQgQgQgQgQgQgQgQgQgQgQgQgQgQgQgQgQgQgQgQgQgQgQgQgQgQgQgQgQgQgQgQgQgQgQgQgQgQgQgQgQgQgQg
QgQgQgQgQgQgQgQgQgQgQgQgQgQgQgQgQgQgQgQgQgQgQgQgQgQgQgQgQgQgQgQgQgQgQgQgQgQgQgQgQgQgQgQgQgQgQgQgQgQg
QgQgQgQgQgQgQgQgQgQgQgQgQgQgQgQgQgQgQgQgQgQgQgQgQgQgQgQgQgQgQgQgQgQgQgQgQgQgQgQgQgQgQgQgQgQgQgQgQgQg
QgQgQgQgQgQgQgQgQgQgQgQgQgQgQgQgQgQgQgQgQgQgQgQgQgQgQgQgQgQgQgQgQgQgQgQgQgQgQgQgQgQgQgQgQgQgQgQgQgQg
QgQgQgQgQgQgQgQgQgQgQgQgQgQgQgQgQgQgQgQgQgQgQgQgQgQgQgQgQgQgQgQgQgQgQgQgQgQgQgQgQgQgQgQgQgQgQgQgQgQg
QgQgQgQgQgQgQgQgQgQgQgQgQgQgQgQgQgQgQgQgQgQgQgQgQgQgQgQgQgQgQgQgQgQgQgQgQgQgQgQgQgQgQgQgQgQgQgQgQgQg
QgQgQgQgQgQgQgQgQgQgQgQgQgQgQgQgQgQgQgQgQgQgQgQgQgQgQgQgQgQgQgQgQgQgQgQgQgQgQgQgQgQgQgQgQgQgQgQgQgQg
"}
