"bp" = (/mob/living/carbon/alien/diona,/turf/simulated/floor/diona,/area/submap/outpost21/structure_generic)
"bB" = (/turf/simulated/wall/diona,/area/submap/outpost21/structure_generic)
"eh" = (/turf/template_noop,/area/template_noop)
"er" = (/mob/living/carbon/alien/diona,/turf/simulated/mineral/floor/ignore_cavegen/cave,/area/submap/outpost21/structure_generic)
"jD" = (/obj/random/plushie,/turf/simulated/floor/diona,/area/submap/outpost21/structure_generic)
"lk" = (/obj/structure/flora/lily1,/obj/random/powercell,/turf/simulated/floor/diona,/area/submap/outpost21/structure_generic)
"ne" = (/obj/structure/flora/lily1,/turf/simulated/floor/diona,/area/submap/outpost21/structure_generic)
"nt" = (/obj/structure/diona/bulb/sea_of_stars{pixel_y = 6},/obj/structure/flora/underwater/grass1,/turf/simulated/floor/diona,/area/submap/outpost21/structure_generic)
"oK" = (/mob/living/carbon/alien/diona,/obj/random/maintenance/research,/turf/simulated/floor/diona,/area/submap/outpost21/structure_generic)
"pt" = (/obj/random/material/precious,/turf/simulated/floor/diona,/area/submap/outpost21/structure_generic)
"pV" = (/obj/structure/flora/lily1,/obj/random/tool/alien,/turf/simulated/floor/diona,/area/submap/outpost21/structure_generic)
"qA" = (/obj/structure/flora/underwater/grass1,/turf/simulated/floor/diona,/area/submap/outpost21/structure_generic)
"qS" = (/obj/random/maintenance/research,/turf/simulated/mineral/floor/ignore_cavegen/cave,/area/submap/outpost21/structure_generic)
"sK" = (/obj/structure/flora/underwater/plant4,/turf/simulated/floor/diona,/area/submap/outpost21/structure_generic)
"tJ" = (/mob/living/carbon/alien/diona,/obj/random/material/precious,/turf/simulated/floor/diona,/area/submap/outpost21/structure_generic)
"wP" = (/obj/structure/diona/vines,/turf/simulated/floor/diona,/area/submap/outpost21/structure_generic)
"zb" = (/obj/structure/flora/tree/jungle_small,/turf/simulated/mineral/floor/ignore_cavegen/cave,/area/submap/outpost21/structure_generic)
"zz" = (/obj/structure/flora/lily3,/obj/random/mega_nukies,/turf/simulated/floor/diona,/area/submap/outpost21/structure_generic)
"BG" = (/turf/simulated/mineral/floor/dirt,/area/submap/outpost21/structure_generic)
"FP" = (/obj/structure/flora/tree/jungle{pixel_y = -22},/obj/structure/flora/underwater/grass1,/turf/simulated/floor/diona,/area/submap/outpost21/structure_generic)
"GY" = (/obj/structure/diona/bulb,/turf/simulated/floor/diona,/area/submap/outpost21/structure_generic)
"Id" = (/obj/structure/flora/underwater/grass4,/obj/random/tool/alien,/turf/simulated/floor/diona,/area/submap/outpost21/structure_generic)
"Is" = (/obj/machinery/portable_atmospherics/hydroponics/soil,/turf/simulated/mineral/floor/ignore_cavegen/cave,/area/submap/outpost21/structure_generic)
"Jb" = (/turf/template_noop,/area/submap/outpost21/structure_generic)
"Jx" = (/obj/random/maintenance/research,/turf/simulated/floor/diona,/area/submap/outpost21/structure_generic)
"JM" = (/turf/simulated/mineral/floor/ignore_cavegen/cave,/area/submap/outpost21/structure_generic)
"Mq" = (/obj/random/outcrop,/turf/simulated/mineral/floor/ignore_cavegen/cave,/area/submap/outpost21/structure_generic)
"Nh" = (/obj/random/maintenance/cargo,/turf/simulated/floor/diona,/area/submap/outpost21/structure_generic)
"SM" = (/obj/random/maintenance/cargo,/turf/simulated/mineral/floor/ignore_cavegen/cave,/area/submap/outpost21/structure_generic)
"Tp" = (/obj/random/maintenance,/turf/simulated/floor/diona,/area/submap/outpost21/structure_generic)
"TQ" = (/obj/structure/flora/lily1,/obj/random/contraband,/turf/simulated/floor/diona,/area/submap/outpost21/structure_generic)
"TY" = (/obj/structure/flora/underwater/plant2,/turf/simulated/floor/diona,/area/submap/outpost21/structure_generic)
"Uw" = (/turf/simulated/mineral/vacuum,/area/submap/outpost21/structure_generic)
"Uz" = (/obj/structure/flora/underwater/grass4,/turf/simulated/floor/diona,/area/submap/outpost21/structure_generic)
"WS" = (/obj/structure/flora/underwater/plant1,/turf/simulated/floor/diona,/area/submap/outpost21/structure_generic)
"WZ" = (/obj/structure/flora/lily3,/turf/simulated/floor/diona,/area/submap/outpost21/structure_generic)
"Yc" = (/obj/structure/flora/underwater/grass1,/obj/random/tool/alien,/turf/simulated/floor/diona,/area/submap/outpost21/structure_generic)
"YO" = (/obj/structure/flora/underwater/grass4,/obj/random/powercell,/turf/simulated/floor/diona,/area/submap/outpost21/structure_generic)
"YR" = (/mob/living/carbon/alien/diona,/obj/structure/flora/lily1,/turf/simulated/floor/diona,/area/submap/outpost21/structure_generic)
"YT" = (/turf/simulated/floor/diona,/area/submap/outpost21/structure_generic)

(1,1,1) = {"
eheheheheheheheheheheheheheheheheheheheheheheheheheheheheheheheheheheheheheheheh
ehJbJbJbJbJbJbbBbBJbJbJbJbJbJbJbJbJbJbJbJbJbJbJbJbJbJbJbJbJbJbJbJbJbJbJbJbJbJbeh
ehJbJbJbJbJbbBbBbBbBbBJbJbJbJbJbJbJbJbJbbBJbbBJbJbJbbBbBbBJbJbJbJbJbJbJbJbJbJbeh
ehJbJbJbJbJbJbJbbBbBbBbBbBJbbBbBbBbBbBbBbBbBbBbBJbbBbBbBJbJbJbJbJbJbJbJbJbJbJbeh
ehJbJbJbJbJbJbJbJbJbbBbBbBbBbBbBbBbBbBbBYTYTWSbBbBbBbBJbJbJbJbJbJbJbJbJbJbJbJbeh
ehJbJbJbJbJbJbJbJbJbJbbBGYsKbBbBsKWZbBbBUzYTbBbBbBbBbBJbJbJbJbUwUwUwUwJbJbJbJbeh
ehJbJbJbJbJbJbJbJbJbJbbBYcneptYTYTYTbBbBbBbBbBWZGYbBJbJbJbJbJbUwUwUwUwJbJbJbJbeh
ehJbJbJbJbJbJbJbJbJbJbbBbBYTYTIszbbpYTTYbBYTneYTWSbBJbJbJbJbUwUwUwUwJbJbJbJbJbeh
ehJbJbJbJbJbJbJbJbbBbBbBbBptJMJMIsYTYTYTwPYTYTTpbBbBbBJbJbJbJbUwUwJbJbJbJbJbJbeh
ehJbJbJbJbJbJbJbJbbBbBWSYTbpIsJMYTneYTqAbBbBbBwPbBbBbBJbJbJbJbJbJbJbJbJbJbJbJbeh
ehJbJbJbJbJbJbJbJbbBbBpVjDptJMtJYTbBbBbBbBbBYTYTzzbBbBJbJbJbJbJbJbJbJbJbJbJbJbeh
ehJbJbJbJbJbJbJbbBbBbBbBbBYTYTYTYTbBbBbBbBWZYTYTYRbBbBbBJbJbJbJbJbJbJbJbJbJbJbeh
ehJbJbJbJbJbJbJbbBbBWZbBbBbBbBptYTbBbBbBYTBGGYYTsKbBbBbBJbJbJbJbJbJbJbJbJbJbJbeh
ehJbJbJbJbJbJbJbbBbBYTUzYTbBbBbBwPbBbBYTIszbJMYTbBbBbBbBJbJbJbJbJbJbJbJbJbJbJbeh
ehJbJbJbJbJbJbbBbBbBYTIszbYTqAYTYTbBbBneerJMYTbBbBbBbBbBbBJbJbJbJbJbJbJbJbJbJbeh
ehJbJbJbJbbBbBbBbBbBNhJMerSMYTYTYTYTwPYTJMIsYTwPYTUzbBbBbBJbJbJbJbJbJbJbJbJbJbeh
ehJbJbJbbBbBYTUzbBWSYTGYJMIsYTbBbBbBbBbBYTYTYTbBYTYTWSbBbBbBJbJbJbJbJbJbJbJbJbeh
ehJbJbJbJbbBYTYTbBYTYTNhIsYTbBbBbBbBbBbBbBTYbBbBYTTQYTbBbBbBbBJbJbJbJbJbJbJbJbeh
ehJbJbJbbBbBWSYTbBUzYTYTYTYTwPYTYTWZGYbBbBbBbBbBbBYToKYTbBbBbBJbJbJbJbJbJbJbJbeh
ehJbJbJbJbbBbBbBbBbBbBwPbBbBbBYTYTYTYTYTnebBbBbBbBYTYTJxTQbBbBbBbBJbJbJbJbJbJbeh
ehJbUwUwJbJbJbbBbBbBYTYTbBbBneYTUzerJMJMYTGYbBbBbBbBYTYTYTYTsKYObBbBJbJbJbJbJbeh
ehJbUwUwJbJbJbbBbBneTpYTbBbBGYsKJMJMFPJMJMYTnebBbBbBwPbBbBjDoKYTGYbBbBbBbBbBJbeh
ehJbUwUwUwJbJbJbbBbBYTWSbBbBbBYTerJMntJMerJMsKWZbBbBYTYTbBbBTYWZbBbBbBbBbBJbJbeh
ehJbJbUwUwJbJbJbbBbBYTTpnebBbBWZYTJMJMJMJMJMGYbBbBYOYTYTsKbBbBbBbBJbJbJbJbJbJbeh
ehJbJbJbJbJbJbbBbBzzYTYTbpbBbBbBGYYTerJMJMqAnebBbBTYIszbWZbBbBJbJbJbJbJbJbJbJbeh
ehJbJbJbJbJbJbbBbBGYIdbBYTYTbBbBbBneYTWSGYbBbBbBbBqSerIslkbBbBJbJbJbJbJbJbJbJbeh
ehJbJbJbJbJbJbbBbBbBbBbBbBTYYTbBbBbBwPbBbBbBbBbBYTIsMqYTbBbBbBJbJbJbJbJbJbJbJbeh
ehJbJbJbJbbBbBbBbBbBbBbBbBWZqAYTwPYTYTbpYTYTYTwPYTYTYTJxbBbBJbJbJbJbJbJbJbJbJbeh
ehJbJbJbbBbBbBbBJbJbJbbBbBbBbBbBbBneYTUzsKWZbBbBbBbBbBGYbBbBJbJbJbJbJbJbJbJbJbeh
ehJbJbJbJbJbJbJbJbJbJbJbbBbBbBbBbBbBbBbBbBbBbBbBUzYTbBbBbBbBJbJbJbJbJbJbJbJbJbeh
ehJbJbJbJbJbJbJbJbJbJbJbJbJbJbJbbBbBbBbBbBbBbBbBYTYTWSbBbBJbJbJbJbJbJbJbJbJbJbeh
ehJbJbJbJbUwUwUwJbJbJbJbJbJbJbJbbBbBbBJbJbJbJbbBbBbBbBbBbBbBJbJbJbJbJbJbJbJbJbeh
ehJbJbUwUwUwUwUwUwJbJbJbJbJbJbJbbBbBJbJbJbJbJbJbbBJbbBJbbBbBJbJbJbJbJbJbJbJbJbeh
ehJbJbUwUwUwUwUwUwJbJbJbJbJbJbJbbBbBJbJbJbJbJbJbJbJbJbJbJbbBJbUwUwUwJbJbJbJbJbeh
ehJbJbJbUwUwUwUwUwJbJbJbJbJbJbJbJbbBJbJbJbJbJbJbJbJbJbJbJbJbJbUwUwUwUwJbJbJbJbeh
ehJbJbJbJbUwUwJbJbJbJbJbJbJbJbJbJbJbJbJbJbJbJbJbJbJbJbJbJbJbJbUwUwUwUwJbJbJbJbeh
ehJbJbJbJbJbJbJbJbJbJbJbJbJbJbJbJbJbJbJbJbJbJbJbJbJbJbJbJbJbJbJbUwUwUwJbJbJbJbeh
ehJbJbJbJbJbJbJbJbJbJbJbJbJbJbJbJbJbJbJbJbJbJbJbJbJbJbJbJbJbJbJbJbUwUwJbJbJbJbeh
ehJbJbJbJbJbJbJbJbJbJbJbJbJbJbJbJbJbJbJbJbJbJbJbJbJbJbJbJbJbJbJbJbJbJbJbJbJbJbeh
eheheheheheheheheheheheheheheheheheheheheheheheheheheheheheheheheheheheheheheheh
"}
