"a" = (/turf/simulated/mineral/alt/ignore_cavegen/muriki,/area/space)
"c" = (/turf/simulated/mineral/floor/muriki{ignore_mapgen = 1},/area/space)
"i" = (/obj/item/storage/firstaid/bonemed,/turf/simulated/floor/outdoors/grass/forest,/area/space)
"m" = (/obj/item/dnainjector/random_verygood_labeled,/turf/simulated/floor/outdoors/grass/forest,/area/space)
"o" = (/obj/structure/loot_pile/surface/bones,/turf/simulated/floor/outdoors/grass/forest,/area/space)
"s" = (/obj/item/dnainjector/random,/turf/simulated/floor/outdoors/grass/forest,/area/space)
"u" = (/turf/simulated/mineral/alt/muriki,/area/space)
"v" = (/obj/machinery/portable_atmospherics/hydroponics/soil,/turf/simulated/floor/outdoors/grass/forest,/area/space)
"x" = (/turf/simulated/floor/outdoors/grass/forest,/area/space)
"z" = (/mob/living/simple_mob/vore/pitcher_plant,/turf/simulated/floor/outdoors/grass/forest,/area/space)
"H" = (/obj/structure/closet/crate/mimic/cointoss,/obj/random/contraband,/turf/simulated/floor/outdoors/grass/forest,/area/space)
"J" = (/mob/living/simple_mob/vore/pitcher,/turf/simulated/floor/outdoors/grass/forest,/area/space)
"Y" = (/obj/item/bone,/obj/item/bone,/obj/item/bone,/obj/item/bone/skull/unknown,/turf/simulated/floor/outdoors/grass/forest,/area/space)
"Z" = (/mob/living/simple_mob/vore/mantrap,/turf/simulated/floor/outdoors/grass/forest,/area/space)

(1,1,1) = {"
uuuuuuuuuuuuuc
uuavxxxxaaaauu
uaaxxaaxxxJaau
uasZxxxxZxxxau
uxxxxaoxxxxxiu
uxJxxxxYvxxxvu
uxxxxZxmxxzxvu
uaxaxxxxxxxxxu
uavxxxaxxxxHau
uaaaaxxzaxaaau
uuuuuuuuuuuuuc
"}
