//MAP CONVERTED BY dmm2tgm.py THIS HEADER COMMENT PREVENTS RECONVERSION, DO NOT REMOVE
"a" = (
/turf/template_noop,
/area/submap/outpost21/yard_sinkhole)
"c" = (
/obj/structure/cliff{
	dir = 9
	},
/turf/simulated/floor/outdoors/mud/turfpack/muriki,
/area/submap/outpost21/yard_sinkhole)
"l" = (
/turf/simulated/floor/outdoors/mud/turfpack/muriki,
/area/submap/outpost21/yard_sinkhole)
"n" = (
/obj/structure/cliff/corner{
	dir = 6
	},
/turf/simulated/floor/outdoors/mud/turfpack/muriki,
/area/submap/outpost21/yard_sinkhole)
"u" = (
/obj/structure/cliff{
	dir = 5
	},
/turf/simulated/floor/outdoors/mud/turfpack/muriki,
/area/submap/outpost21/yard_sinkhole)
"w" = (
/obj/structure/cliff_end{
	dir = 8
	},
/turf/simulated/floor/outdoors/mud/turfpack/muriki,
/area/submap/outpost21/yard_sinkhole)
"x" = (
/obj/structure/cliff_end,
/turf/simulated/floor/outdoors/mud/turfpack/muriki,
/area/submap/outpost21/yard_sinkhole)
"z" = (
/turf/template_noop,
/area/template_noop)
"A" = (
/obj/structure/cliff_end{
	dir = 4
	},
/turf/simulated/floor/outdoors/mud/turfpack/muriki,
/area/submap/outpost21/yard_sinkhole)
"C" = (
/obj/structure/cliff{
	dir = 10
	},
/turf/simulated/floor/outdoors/mud/turfpack/muriki,
/area/submap/outpost21/yard_sinkhole)
"E" = (
/turf/simulated/open/muriki,
/area/submap/outpost21/yard_sinkhole)
"G" = (
/obj/structure/cliff/corner{
	dir = 9
	},
/turf/simulated/floor/outdoors/mud/turfpack/muriki,
/area/submap/outpost21/yard_sinkhole)
"H" = (
/obj/structure/cliff_end{
	dir = 1
	},
/turf/simulated/floor/outdoors/mud/turfpack/muriki,
/area/submap/outpost21/yard_sinkhole)
"N" = (
/obj/structure/cliff{
	dir = 4
	},
/turf/simulated/floor/outdoors/mud/turfpack/muriki,
/area/submap/outpost21/yard_sinkhole)
"O" = (
/obj/structure/cliff{
	dir = 6
	},
/turf/simulated/floor/outdoors/mud/turfpack/muriki,
/area/submap/outpost21/yard_sinkhole)
"P" = (
/obj/structure/cliff/corner{
	dir = 5
	},
/turf/simulated/floor/outdoors/mud/turfpack/muriki,
/area/submap/outpost21/yard_sinkhole)
"U" = (
/obj/structure/cliff/corner{
	dir = 10
	},
/turf/simulated/floor/outdoors/mud/turfpack/muriki,
/area/submap/outpost21/yard_sinkhole)
"W" = (
/obj/structure/cliff,
/turf/simulated/floor/outdoors/mud/turfpack/muriki,
/area/submap/outpost21/yard_sinkhole)
"X" = (
/obj/structure/cliff{
	dir = 8
	},
/turf/simulated/floor/outdoors/mud/turfpack/muriki,
/area/submap/outpost21/yard_sinkhole)
"Y" = (
/obj/structure/cliff{
	dir = 1
	},
/turf/simulated/floor/outdoors/mud/turfpack/muriki,
/area/submap/outpost21/yard_sinkhole)

(1,1,1) = {"
z
z
z
z
z
z
z
z
z
z
z
z
z
z
z
"}
(2,1,1) = {"
z
z
z
z
z
z
z
z
z
z
z
z
z
z
z
"}
(3,1,1) = {"
z
z
z
z
A
l
l
l
A
a
a
z
z
z
z
"}
(4,1,1) = {"
z
z
z
l
W
l
l
l
Y
l
l
A
a
z
z
"}
(5,1,1) = {"
z
z
z
l
C
X
X
X
c
l
l
W
l
z
z
"}
(6,1,1) = {"
z
z
l
l
l
l
G
X
U
l
l
W
l
a
z
"}
(7,1,1) = {"
z
z
x
N
u
G
c
l
C
X
U
W
l
a
z
"}
(8,1,1) = {"
z
z
a
l
Y
Y
l
E
E
l
W
W
l
l
z
"}
(9,1,1) = {"
z
z
a
l
Y
P
u
l
l
O
n
C
X
H
z
"}
(10,1,1) = {"
z
z
a
l
w
l
P
N
N
n
l
l
l
a
z
"}
(11,1,1) = {"
z
z
a
l
x
N
N
N
N
N
N
H
a
z
z
"}
(12,1,1) = {"
z
z
z
a
l
l
l
l
l
l
l
l
z
z
z
"}
(13,1,1) = {"
z
z
z
z
a
a
l
l
l
l
a
z
z
z
z
"}
(14,1,1) = {"
z
z
z
z
z
z
z
z
z
z
z
z
z
z
z
"}
(15,1,1) = {"
z
z
z
z
z
z
z
z
z
z
z
z
z
z
z
"}
