"a" = (/turf/template_noop,/area/template_noop)
"g" = (/obj/machinery/trailblazer/yellow,/turf/simulated/mineral/floor/ignore_cavegen/muriki,/area/mine/explored/muriki/cave/deepdark)
"R" = (/turf/simulated/floor/outdoors/sidewalk/muriki{icon_state = "slab"},/area/mine/explored/muriki/cave/deepdark)
"W" = (/turf/simulated/mineral/floor/ignore_cavegen/muriki,/area/mine/explored/muriki/cave/deepdark)

(1,1,1) = {"
aaaaa
aWRWa
aWgRa
aRWWa
aaaaa
"}
