//MAP CONVERTED BY dmm2tgm.py THIS HEADER COMMENT PREVENTS RECONVERSION, DO NOT REMOVE
"a" = (
/turf/template_noop,
/area/mine/explored/muriki/cave/deepdark)
"v" = (
/turf/simulated/floor/water/deep/indoors/turfpack/muriki,
/area/mine/explored/muriki/cave/deepdark)
"C" = (
/obj/structure/flora/mushroom,
/turf/simulated/mineral/floor/ignore_cavegen/turfpack/muriki,
/area/mine/explored/muriki/cave/deepdark)
"J" = (
/obj/structure/flora/ausbushes/reedbush,
/turf/simulated/floor/water/turfpack/muriki,
/area/mine/explored/muriki/cave/deepdark)
"L" = (
/turf/template_noop,
/area/template_noop)
"R" = (
/obj/structure/flora/ausbushes/stalkybush,
/turf/simulated/mineral/floor/ignore_cavegen/turfpack/muriki,
/area/mine/explored/muriki/cave/deepdark)
"S" = (
/turf/simulated/floor/water/turfpack/muriki,
/area/mine/explored/muriki/cave/deepdark)
"W" = (
/obj/structure/prop/rock,
/turf/simulated/mineral/floor/ignore_cavegen/turfpack/muriki,
/area/mine/explored/muriki/cave/deepdark)
"Y" = (
/turf/simulated/mineral/floor/ignore_cavegen/turfpack/muriki,
/area/mine/explored/muriki/cave/deepdark)

(1,1,1) = {"
L
L
L
L
L
L
L
L
L
L
L
L
L
L
L
"}
(2,1,1) = {"
L
L
L
L
L
L
L
L
L
L
L
L
L
L
L
"}
(3,1,1) = {"
L
L
L
L
L
a
a
a
a
a
a
L
L
L
L
"}
(4,1,1) = {"
L
L
L
L
a
a
a
a
a
a
a
a
L
L
L
"}
(5,1,1) = {"
L
L
L
L
a
a
a
a
Y
C
a
a
a
L
L
"}
(6,1,1) = {"
L
L
L
a
a
a
Y
R
Y
C
a
a
a
L
L
"}
(7,1,1) = {"
L
L
L
a
a
a
S
S
S
J
Y
a
a
L
L
"}
(8,1,1) = {"
L
L
L
a
a
S
S
v
v
S
W
a
a
L
L
"}
(9,1,1) = {"
L
L
L
a
a
S
v
v
S
Y
Y
a
a
L
L
"}
(10,1,1) = {"
L
L
L
L
a
S
J
S
C
R
a
a
a
L
L
"}
(11,1,1) = {"
L
L
L
L
a
a
a
S
a
a
a
a
L
L
L
"}
(12,1,1) = {"
L
L
L
L
L
a
a
a
a
a
a
L
L
L
L
"}
(13,1,1) = {"
L
L
L
L
L
L
L
L
L
L
L
L
L
L
L
"}
(14,1,1) = {"
L
L
L
L
L
L
L
L
L
L
L
L
L
L
L
"}
(15,1,1) = {"
L
L
L
L
L
L
L
L
L
L
L
L
L
L
L
"}
