//MAP CONVERTED BY dmm2tgm.py THIS HEADER COMMENT PREVENTS RECONVERSION, DO NOT REMOVE
"a" = (
/turf/simulated/mineral/alt/ignore_cavegen/turfpack/muriki,
/area/mine/explored/muriki/cave/deepdark)
"b" = (
/turf/unsimulated/mineral/muriki/basalt,
/area/template_noop)
"d" = (
/turf/template_noop,
/area/mine/explored/muriki/cave/deepdark)
"g" = (
/turf/simulated/mineral/floor/ignore_cavegen/turfpack/muriki,
/area/mine/explored/muriki/cave/deepdark)
"m" = (
/obj/effect/map_effect/portal/line/side_b{
	dir = 4
	},
/turf/simulated/mineral/floor/ignore_cavegen/turfpack/muriki,
/area/mine/explored/muriki/cave/deepdark)
"o" = (
/turf/template_noop,
/area/template_noop)
"t" = (
/turf/unsimulated/mineral/muriki/basalt,
/area/mine/explored/muriki/cave/deepdark)
"H" = (
/obj/effect/map_effect/portal/master/side_a{
	dir = 8;
	portal_id = "deepdark_portal_C"
	},
/turf/simulated/mineral/floor/ignore_cavegen/turfpack/muriki,
/area/mine/explored/muriki/cave/deepdark)
"I" = (
/obj/effect/map_effect/portal/master/side_b{
	dir = 4;
	portal_id = "deepdark_portal_C"
	},
/turf/simulated/mineral/floor/ignore_cavegen/turfpack/muriki,
/area/mine/explored/muriki/cave/deepdark)
"T" = (
/obj/effect/map_effect/portal/line/side_a{
	dir = 8
	},
/turf/simulated/mineral/floor/ignore_cavegen/turfpack/muriki,
/area/mine/explored/muriki/cave/deepdark)

(1,1,1) = {"
o
o
o
o
o
o
o
o
o
o
o
o
o
o
o
o
o
o
o
o
"}
(2,1,1) = {"
o
o
o
o
o
o
o
o
o
o
o
o
o
o
o
o
o
o
o
o
"}
(3,1,1) = {"
o
o
o
o
o
o
o
o
o
o
o
o
o
o
o
o
o
o
o
o
"}
(4,1,1) = {"
o
o
o
o
o
d
d
d
d
d
o
o
o
o
o
o
o
o
o
o
"}
(5,1,1) = {"
o
o
o
d
d
d
d
d
d
d
d
d
d
o
o
o
o
o
o
o
"}
(6,1,1) = {"
o
o
o
d
d
d
d
d
d
d
d
d
d
d
o
o
o
o
o
o
"}
(7,1,1) = {"
o
o
d
d
d
a
a
t
t
t
t
t
t
t
d
o
o
o
o
o
"}
(8,1,1) = {"
o
o
d
d
a
t
t
t
t
t
t
t
t
t
t
d
d
o
o
o
"}
(9,1,1) = {"
o
o
d
t
t
t
t
t
t
t
t
t
t
t
t
t
d
o
o
o
"}
(10,1,1) = {"
o
o
d
t
t
t
t
t
t
t
t
t
t
t
t
t
t
o
o
o
"}
(11,1,1) = {"
o
o
t
t
t
t
t
t
t
t
t
t
t
t
t
t
t
d
o
o
"}
(12,1,1) = {"
o
d
t
t
t
t
t
t
t
t
t
t
t
t
t
t
t
t
o
o
"}
(13,1,1) = {"
o
d
t
t
t
t
t
t
t
t
t
t
t
t
t
t
t
t
o
o
"}
(14,1,1) = {"
o
d
t
t
t
t
t
t
t
t
t
t
t
t
t
t
t
t
o
o
"}
(15,1,1) = {"
o
d
t
t
t
t
t
t
t
t
t
t
t
t
t
t
t
t
o
o
"}
(16,1,1) = {"
o
d
t
t
t
t
t
t
t
t
t
t
t
t
t
t
t
t
d
o
"}
(17,1,1) = {"
o
d
d
t
t
t
t
t
I
m
m
m
t
t
t
t
t
d
d
o
"}
(18,1,1) = {"
o
d
d
a
t
t
t
t
g
g
g
g
t
t
t
t
d
d
d
o
"}
(19,1,1) = {"
o
d
d
d
a
t
g
g
g
g
g
g
g
t
t
d
d
d
d
o
"}
(20,1,1) = {"
o
o
d
d
d
g
g
g
g
g
g
g
g
g
d
d
a
a
t
o
"}
(21,1,1) = {"
o
o
d
d
d
d
g
g
g
g
g
g
g
g
d
d
a
t
t
o
"}
(22,1,1) = {"
o
b
t
d
d
d
d
g
d
d
g
g
g
g
d
d
t
t
d
o
"}
(23,1,1) = {"
o
b
t
t
d
d
d
d
d
d
d
g
g
d
d
d
d
d
d
o
"}
(24,1,1) = {"
o
o
t
t
d
d
d
d
d
d
d
d
d
d
d
d
d
d
o
o
"}
(25,1,1) = {"
o
d
d
d
d
a
a
d
d
d
d
d
d
t
t
d
d
d
o
o
"}
(26,1,1) = {"
o
d
d
d
d
t
t
a
g
d
d
d
g
t
t
d
d
d
o
o
"}
(27,1,1) = {"
o
d
d
d
d
t
a
a
g
d
d
d
a
t
t
t
d
o
o
o
"}
(28,1,1) = {"
o
d
d
d
t
t
a
g
g
d
d
d
a
a
t
t
d
o
o
o
"}
(29,1,1) = {"
o
d
d
d
t
t
g
g
d
d
d
d
g
a
a
d
d
o
o
o
"}
(30,1,1) = {"
o
d
d
d
d
g
g
g
d
d
d
d
d
d
d
d
d
o
o
o
"}
(31,1,1) = {"
o
d
d
d
d
g
g
g
d
d
d
d
d
d
d
d
d
o
o
o
"}
(32,1,1) = {"
o
d
t
t
d
g
g
g
g
d
d
d
d
g
d
d
d
o
o
o
"}
(33,1,1) = {"
o
b
t
t
d
t
g
g
g
g
g
g
g
g
d
d
d
o
o
o
"}
(34,1,1) = {"
o
o
d
d
d
t
t
t
g
g
g
g
t
t
t
a
a
d
o
o
"}
(35,1,1) = {"
o
o
d
a
t
t
t
t
H
T
T
T
t
t
t
t
t
a
o
o
"}
(36,1,1) = {"
o
d
t
t
t
t
t
t
t
t
t
t
t
t
t
t
t
t
o
o
"}
(37,1,1) = {"
o
a
t
t
t
t
t
t
t
t
t
t
t
t
t
t
t
t
o
o
"}
(38,1,1) = {"
o
a
t
t
t
t
t
t
t
t
t
t
t
t
t
t
t
t
o
o
"}
(39,1,1) = {"
o
a
t
t
t
t
t
t
t
t
t
t
t
t
t
t
t
t
o
o
"}
(40,1,1) = {"
o
d
t
t
t
t
t
t
t
t
t
t
t
t
t
t
t
t
o
o
"}
(41,1,1) = {"
o
d
t
t
t
t
t
t
t
t
t
t
t
t
t
t
t
d
o
o
"}
(42,1,1) = {"
o
d
t
t
t
t
t
t
t
t
t
t
t
t
t
t
t
o
o
o
"}
(43,1,1) = {"
o
o
a
t
t
t
t
t
t
t
t
t
t
t
t
t
t
o
o
o
"}
(44,1,1) = {"
o
o
d
a
t
t
t
t
t
t
t
t
t
t
t
t
d
o
o
o
"}
(45,1,1) = {"
o
o
d
d
a
t
t
t
t
t
t
t
t
t
t
d
d
o
o
o
"}
(46,1,1) = {"
o
o
d
d
d
a
a
a
a
t
t
t
a
d
d
o
o
o
o
o
"}
(47,1,1) = {"
o
o
o
d
d
d
d
d
a
a
a
a
a
d
o
o
o
o
o
o
"}
(48,1,1) = {"
o
o
o
o
o
d
d
d
d
d
d
d
d
d
o
o
o
o
o
o
"}
(49,1,1) = {"
o
o
o
o
o
o
o
o
o
o
o
o
o
o
o
o
o
o
o
o
"}
(50,1,1) = {"
o
o
o
o
o
o
o
o
o
o
o
o
o
o
o
o
o
o
o
o
"}
