//MAP CONVERTED BY dmm2tgm.py THIS HEADER COMMENT PREVENTS RECONVERSION, DO NOT REMOVE
"a" = (
/turf/simulated/mineral/floor/ignore_cavegen/turfpack/muriki,
/area/mine/explored/muriki/cave/deepdark)
"f" = (
/obj/effect/map_effect/portal/line/side_b{
	dir = 4
	},
/turf/simulated/mineral/floor/ignore_cavegen/turfpack/muriki,
/area/mine/explored/muriki/cave/deepdark)
"h" = (
/turf/unsimulated/mineral/muriki/basalt,
/area/template_noop)
"o" = (
/turf/simulated/mineral/alt/ignore_cavegen/turfpack/muriki,
/area/mine/explored/muriki/cave/deepdark)
"q" = (
/turf/template_noop,
/area/mine/explored/muriki/cave/deepdark)
"u" = (
/turf/simulated/mineral/alt/ignore_cavegen/turfpack/muriki,
/area/template_noop)
"A" = (
/obj/effect/map_effect/portal/line/side_a{
	dir = 8
	},
/turf/simulated/mineral/floor/ignore_cavegen/turfpack/muriki,
/area/mine/explored/muriki/cave/deepdark)
"B" = (
/turf/template_noop,
/area/template_noop)
"I" = (
/obj/effect/map_effect/portal/master/side_a{
	dir = 8;
	portal_id = "deepdark_portal_A"
	},
/turf/simulated/mineral/floor/ignore_cavegen/turfpack/muriki,
/area/mine/explored/muriki/cave/deepdark)
"L" = (
/turf/unsimulated/mineral/muriki/basalt,
/area/mine/explored/muriki/cave/deepdark)
"O" = (
/turf/simulated/mineral/floor/ignore_cavegen/turfpack/muriki,
/area/template_noop)
"S" = (
/obj/effect/map_effect/portal/master/side_b{
	dir = 4;
	portal_id = "deepdark_portal_A"
	},
/turf/simulated/mineral/floor/ignore_cavegen/turfpack/muriki,
/area/mine/explored/muriki/cave/deepdark)

(1,1,1) = {"
B
B
B
B
B
B
B
B
B
B
B
B
B
B
B
B
B
B
B
B
B
B
B
B
B
B
B
B
B
B
"}
(2,1,1) = {"
B
B
B
B
B
B
B
B
B
B
B
B
B
B
B
B
B
B
B
B
B
B
B
B
B
B
B
B
B
B
"}
(3,1,1) = {"
B
B
B
B
B
B
B
B
B
B
B
B
B
B
B
B
B
B
B
B
B
B
B
B
B
B
B
B
B
B
"}
(4,1,1) = {"
B
B
B
B
B
B
B
B
B
B
B
B
B
B
B
B
B
B
B
B
B
B
B
B
B
B
B
B
B
B
"}
(5,1,1) = {"
B
B
B
B
B
B
B
B
B
B
B
B
B
B
B
B
B
B
B
q
q
B
B
B
B
B
B
B
B
B
"}
(6,1,1) = {"
B
B
B
B
B
B
B
B
B
B
B
B
B
B
B
B
B
L
q
a
a
a
q
h
B
B
B
B
B
B
"}
(7,1,1) = {"
B
B
B
B
B
B
B
B
B
B
B
B
B
B
B
B
L
L
a
a
a
a
a
L
h
B
B
B
B
B
"}
(8,1,1) = {"
B
B
B
B
B
B
B
B
B
B
B
B
B
B
B
q
L
L
L
a
a
a
a
L
L
B
B
B
B
B
"}
(9,1,1) = {"
B
B
B
B
B
B
B
B
B
B
B
B
B
B
B
q
L
L
L
a
a
a
a
L
L
q
B
B
B
B
"}
(10,1,1) = {"
B
B
B
B
B
B
B
B
B
B
B
B
B
B
B
q
L
L
L
a
a
a
L
L
L
L
B
B
B
B
"}
(11,1,1) = {"
B
B
B
B
B
B
B
B
B
B
B
B
B
q
o
L
L
L
L
I
A
A
L
L
L
L
B
B
B
B
"}
(12,1,1) = {"
B
B
B
B
B
B
B
B
B
B
B
B
q
o
L
L
L
L
L
L
L
L
L
L
L
L
B
B
B
B
"}
(13,1,1) = {"
B
B
B
B
B
B
B
B
B
B
B
B
o
o
L
L
L
L
L
L
L
L
L
L
L
L
L
B
B
B
"}
(14,1,1) = {"
B
B
B
B
B
B
B
B
B
B
B
B
o
o
L
L
L
L
L
L
L
L
L
L
L
L
L
B
B
B
"}
(15,1,1) = {"
B
B
B
B
B
B
B
B
B
B
B
B
o
o
L
L
L
L
L
L
L
L
L
L
L
L
L
B
B
B
"}
(16,1,1) = {"
B
B
B
B
B
B
B
B
B
B
B
B
q
o
L
L
L
L
L
L
L
L
L
L
L
L
L
B
B
B
"}
(17,1,1) = {"
B
B
B
B
B
B
B
B
B
B
B
B
q
o
L
L
L
L
L
L
L
L
L
L
L
L
L
B
B
B
"}
(18,1,1) = {"
B
B
B
B
B
B
B
B
B
B
B
B
q
o
L
L
L
L
L
L
L
L
L
L
L
L
q
B
B
B
"}
(19,1,1) = {"
B
B
B
B
B
B
B
B
B
B
B
B
B
q
o
L
L
L
L
L
L
L
L
L
L
o
B
B
B
B
"}
(20,1,1) = {"
B
B
B
B
B
B
B
B
B
B
B
B
B
B
B
u
u
h
L
L
L
L
L
h
u
u
B
B
B
B
"}
(21,1,1) = {"
B
B
B
B
B
B
B
B
B
B
B
B
B
B
B
B
u
u
u
u
u
u
u
u
u
B
B
B
B
B
"}
(22,1,1) = {"
B
B
B
B
B
B
B
B
B
B
B
B
B
B
B
B
B
B
B
B
B
B
B
B
B
B
B
B
B
B
"}
(23,1,1) = {"
B
B
B
B
B
B
B
B
B
B
B
B
B
B
B
B
B
B
B
B
B
B
B
B
B
B
B
B
B
B
"}
(24,1,1) = {"
B
B
B
B
B
B
B
B
B
B
B
B
B
B
B
B
B
B
B
B
B
B
B
B
B
B
B
B
B
B
"}
(25,1,1) = {"
B
B
B
B
B
B
B
B
B
B
B
B
B
B
B
B
B
B
B
B
B
B
B
B
B
B
B
B
B
B
"}
(26,1,1) = {"
B
B
B
B
B
B
B
B
B
B
B
B
B
B
B
B
B
B
B
B
B
B
B
B
B
B
B
B
B
B
"}
(27,1,1) = {"
B
B
B
B
B
B
B
B
B
B
B
B
B
B
B
B
B
B
B
B
B
B
B
B
B
B
B
B
B
B
"}
(28,1,1) = {"
B
B
B
B
B
B
B
B
B
B
B
B
B
B
B
B
B
B
B
B
B
B
B
B
B
B
B
B
B
B
"}
(29,1,1) = {"
B
B
B
B
B
B
B
B
B
B
B
B
B
B
B
B
B
B
B
B
B
B
B
B
B
B
B
B
B
B
"}
(30,1,1) = {"
B
B
B
B
B
B
B
B
B
B
B
B
B
B
B
B
B
B
B
B
B
B
B
B
B
B
B
B
B
B
"}
(31,1,1) = {"
B
B
B
B
B
B
B
B
B
B
B
B
B
B
B
B
B
B
B
B
B
B
B
B
B
B
B
B
B
B
"}
(32,1,1) = {"
B
B
B
B
B
B
B
B
B
B
B
B
B
B
B
B
B
B
B
B
B
B
B
B
B
B
B
B
B
B
"}
(33,1,1) = {"
B
B
B
B
B
B
B
B
B
B
B
B
B
B
B
B
B
B
B
B
B
B
B
B
B
B
B
B
B
B
"}
(34,1,1) = {"
B
B
B
B
B
B
B
B
B
B
B
B
B
B
B
B
B
B
B
B
B
B
B
B
B
B
B
B
B
B
"}
(35,1,1) = {"
B
B
B
B
B
B
B
B
B
B
B
B
B
B
B
B
B
B
B
B
B
B
B
B
B
B
B
B
B
B
"}
(36,1,1) = {"
B
B
B
B
B
B
B
B
B
B
B
B
B
B
B
B
B
B
B
B
B
B
B
B
B
B
B
B
B
B
"}
(37,1,1) = {"
B
B
B
B
B
B
B
B
B
B
B
B
B
B
B
B
B
B
B
B
B
B
B
B
B
B
B
B
B
B
"}
(38,1,1) = {"
B
B
B
B
B
B
B
B
B
B
B
B
B
B
B
B
B
B
B
B
B
B
B
B
B
B
B
B
B
B
"}
(39,1,1) = {"
B
B
B
B
B
B
B
B
B
B
B
B
B
B
B
B
B
B
B
B
B
B
B
B
B
B
B
B
B
B
"}
(40,1,1) = {"
B
B
B
B
B
B
B
B
B
B
B
B
B
B
B
B
B
B
B
B
B
B
B
B
B
B
B
B
B
B
"}
(41,1,1) = {"
B
B
B
B
B
B
B
B
B
B
B
B
B
B
B
B
B
B
B
B
B
B
B
B
B
B
B
B
B
B
"}
(42,1,1) = {"
B
B
B
B
B
B
B
B
B
B
B
B
B
B
B
B
B
B
B
B
B
B
B
B
B
B
B
B
B
B
"}
(43,1,1) = {"
B
B
B
B
B
B
B
B
B
B
B
B
B
B
B
B
B
B
B
B
B
B
B
B
B
B
B
B
B
B
"}
(44,1,1) = {"
B
B
B
B
B
B
B
B
B
B
B
B
B
B
B
B
B
B
B
B
B
B
B
B
B
B
B
B
B
B
"}
(45,1,1) = {"
B
B
B
B
B
B
B
B
B
B
B
B
B
B
B
B
B
B
B
B
B
B
B
B
B
B
B
B
B
B
"}
(46,1,1) = {"
B
B
B
B
B
B
B
B
B
B
B
B
B
B
B
B
B
B
B
B
B
B
B
B
B
B
B
B
B
B
"}
(47,1,1) = {"
B
B
B
B
B
B
B
B
B
B
B
B
B
B
B
B
B
B
B
B
B
B
B
B
B
B
B
B
B
B
"}
(48,1,1) = {"
B
B
B
B
B
B
B
B
B
B
B
B
B
B
B
B
B
B
B
B
B
B
B
B
B
B
B
B
B
B
"}
(49,1,1) = {"
B
B
B
B
B
B
B
B
B
B
B
B
B
B
B
B
B
B
B
B
B
B
B
B
B
B
B
B
B
B
"}
(50,1,1) = {"
B
B
B
B
B
B
B
B
B
B
B
B
B
B
B
B
B
B
B
B
B
B
B
B
B
B
B
B
B
B
"}
(51,1,1) = {"
B
B
B
B
B
B
B
B
B
B
B
B
B
B
B
B
B
B
B
B
B
B
B
B
B
B
B
B
B
B
"}
(52,1,1) = {"
B
B
B
B
B
B
B
B
B
B
B
B
B
B
B
B
B
B
B
B
B
B
B
B
B
B
B
B
B
B
"}
(53,1,1) = {"
B
B
B
B
B
B
B
B
B
B
B
B
B
B
B
B
B
B
B
B
B
B
B
B
B
B
B
B
B
B
"}
(54,1,1) = {"
B
B
B
B
B
B
B
B
B
B
B
B
B
B
B
B
B
B
B
B
B
B
B
B
B
B
B
B
B
B
"}
(55,1,1) = {"
B
B
B
B
B
B
B
B
B
B
B
B
B
B
B
B
B
B
B
B
B
B
B
B
B
B
B
B
B
B
"}
(56,1,1) = {"
B
B
B
B
B
B
B
B
B
B
B
B
B
B
B
B
B
B
B
B
B
B
B
B
B
B
B
B
B
B
"}
(57,1,1) = {"
B
B
B
B
B
B
B
B
B
B
B
B
B
B
B
B
B
B
B
B
B
B
B
B
B
B
B
B
B
B
"}
(58,1,1) = {"
B
B
B
B
B
B
B
B
B
B
B
B
B
B
B
B
B
B
B
B
B
B
B
B
B
B
B
B
B
B
"}
(59,1,1) = {"
B
B
B
B
B
B
B
B
B
B
B
B
B
B
B
B
B
B
B
B
B
B
B
B
B
B
B
B
B
B
"}
(60,1,1) = {"
B
B
B
B
B
u
u
B
B
u
u
u
u
u
B
B
B
B
B
B
B
B
B
B
B
B
B
B
B
B
"}
(61,1,1) = {"
B
B
B
B
u
u
h
L
L
L
L
L
h
u
u
u
B
B
B
B
B
B
B
B
B
B
B
B
B
B
"}
(62,1,1) = {"
B
B
B
u
u
L
L
L
L
L
L
L
L
L
L
u
u
B
B
B
B
B
B
B
B
B
B
B
B
B
"}
(63,1,1) = {"
B
B
B
u
h
L
L
L
L
L
L
L
L
L
L
L
u
B
B
B
B
B
B
B
B
B
B
B
B
B
"}
(64,1,1) = {"
B
B
B
h
L
L
L
L
L
L
L
L
L
L
L
L
o
B
B
B
B
B
B
B
B
B
B
B
B
B
"}
(65,1,1) = {"
B
B
B
h
L
L
L
L
L
L
L
L
L
L
L
L
o
B
B
B
B
B
B
B
B
B
B
B
B
B
"}
(66,1,1) = {"
B
B
B
h
L
L
L
L
L
L
L
L
L
L
L
L
L
B
B
B
B
B
B
B
B
B
B
B
B
B
"}
(67,1,1) = {"
B
B
B
h
L
L
L
L
L
L
L
L
L
L
L
L
L
B
B
B
B
B
B
B
B
B
B
B
B
B
"}
(68,1,1) = {"
B
B
B
h
L
L
L
L
L
L
L
L
L
L
L
L
L
B
B
B
B
B
B
B
B
B
B
B
B
B
"}
(69,1,1) = {"
B
B
B
B
L
L
L
L
L
L
L
L
L
L
L
L
o
B
B
B
B
B
B
B
B
B
B
B
B
B
"}
(70,1,1) = {"
B
B
B
B
L
L
L
L
S
f
f
L
L
L
L
L
q
B
B
B
B
B
B
B
B
B
B
B
B
B
"}
(71,1,1) = {"
B
B
B
B
h
L
L
L
a
a
a
L
L
L
L
L
B
B
B
B
B
B
B
B
B
B
B
B
B
B
"}
(72,1,1) = {"
B
B
B
B
B
h
L
L
a
a
a
L
L
L
L
B
B
B
B
B
B
B
B
B
B
B
B
B
B
B
"}
(73,1,1) = {"
B
B
B
B
B
h
L
L
a
a
a
a
L
L
q
B
B
B
B
B
B
B
B
B
B
B
B
B
B
B
"}
(74,1,1) = {"
B
B
B
B
B
B
L
a
a
a
a
a
L
L
B
B
B
B
B
B
B
B
B
B
B
B
B
B
B
B
"}
(75,1,1) = {"
B
B
B
B
B
B
L
a
a
a
a
a
L
q
B
B
B
B
B
B
B
B
B
B
B
B
B
B
B
B
"}
(76,1,1) = {"
B
B
B
B
B
B
h
O
O
O
O
B
h
B
B
B
B
B
B
B
B
B
B
B
B
B
B
B
B
B
"}
(77,1,1) = {"
B
B
B
B
B
B
B
B
B
B
B
B
B
B
B
B
B
B
B
B
B
B
B
B
B
B
B
B
B
B
"}
(78,1,1) = {"
B
B
B
B
B
B
B
B
B
B
B
B
B
B
B
B
B
B
B
B
B
B
B
B
B
B
B
B
B
B
"}
(79,1,1) = {"
B
B
B
B
B
B
B
B
B
B
B
B
B
B
B
B
B
B
B
B
B
B
B
B
B
B
B
B
B
B
"}
(80,1,1) = {"
B
B
B
B
B
B
B
B
B
B
B
B
B
B
B
B
B
B
B
B
B
B
B
B
B
B
B
B
B
B
"}
