//MAP CONVERTED BY dmm2tgm.py THIS HEADER COMMENT PREVENTS RECONVERSION, DO NOT REMOVE
"a" = (
/turf/template_noop,
/area/mine/explored/muriki/cave/deepdark)
"d" = (
/obj/effect/map_effect/interval/collapsing_cavern,
/turf/simulated/mineral/floor/ignore_cavegen/turfpack/muriki,
/area/mine/explored/muriki/cave/deepdark)
"e" = (
/obj/structure/prop/rock/sharp,
/turf/simulated/mineral/floor/ignore_cavegen/turfpack/muriki,
/area/mine/explored/muriki/cave/deepdark)
"k" = (
/obj/structure/prop/rock/small,
/turf/simulated/mineral/floor/ignore_cavegen/turfpack/muriki,
/area/mine/explored/muriki/cave/deepdark)
"l" = (
/turf/template_noop,
/area/mine/unexplored/muriki/cave/deepdark)
"o" = (
/turf/simulated/mineral/floor/ignore_cavegen/turfpack/muriki,
/area/mine/explored/muriki/cave/deepdark)
"p" = (
/obj/structure/prop/rock/small/alt,
/turf/simulated/mineral/floor/ignore_cavegen/turfpack/muriki,
/area/mine/explored/muriki/cave/deepdark)
"u" = (
/obj/structure/prop/rock,
/turf/simulated/mineral/floor/ignore_cavegen/turfpack/muriki,
/area/mine/explored/muriki/cave/deepdark)
"w" = (
/turf/template_noop,
/area/template_noop)
"X" = (
/obj/structure/prop/rock/round,
/turf/simulated/mineral/floor/ignore_cavegen/turfpack/muriki,
/area/mine/explored/muriki/cave/deepdark)

(1,1,1) = {"
w
w
w
w
w
w
w
w
w
w
w
w
w
w
w
w
w
w
w
w
w
w
w
w
w
w
w
w
w
w
"}
(2,1,1) = {"
w
l
l
l
l
l
l
l
l
l
l
l
l
l
l
l
l
l
l
l
l
l
l
l
l
l
l
l
l
w
"}
(3,1,1) = {"
w
l
l
l
l
l
l
l
l
l
l
l
l
l
l
l
l
a
a
a
a
a
a
a
a
l
l
l
l
w
"}
(4,1,1) = {"
w
l
l
a
a
a
a
a
a
a
a
l
l
l
l
a
a
a
a
o
o
o
o
a
a
a
l
l
l
w
"}
(5,1,1) = {"
w
l
a
a
o
o
o
o
a
a
a
a
a
a
a
a
a
a
o
o
o
o
o
o
a
a
a
l
l
w
"}
(6,1,1) = {"
w
l
a
o
o
o
o
o
o
o
o
a
a
a
a
a
o
o
o
o
o
o
o
o
o
a
a
l
l
w
"}
(7,1,1) = {"
w
l
a
o
o
k
o
o
o
o
o
o
o
o
o
o
o
o
o
o
k
e
o
o
o
a
a
a
l
w
"}
(8,1,1) = {"
w
l
a
o
o
u
o
p
o
o
o
o
o
X
o
o
u
o
o
o
p
k
o
o
o
a
a
a
l
w
"}
(9,1,1) = {"
w
l
a
o
o
o
o
u
o
o
o
o
o
o
o
o
o
o
o
o
o
o
X
k
o
a
a
a
l
w
"}
(10,1,1) = {"
w
l
a
a
o
o
o
o
p
k
o
o
o
o
k
p
o
o
o
e
o
d
o
o
o
o
a
a
l
w
"}
(11,1,1) = {"
w
l
a
a
o
o
o
o
k
d
o
o
o
o
k
k
k
o
o
o
o
k
p
o
o
o
a
a
l
w
"}
(12,1,1) = {"
w
l
a
a
o
o
o
o
o
u
k
o
e
o
o
p
p
o
k
k
o
o
k
o
o
o
a
a
l
w
"}
(13,1,1) = {"
w
l
a
a
a
o
o
o
o
o
k
k
o
p
o
o
k
k
k
p
o
o
o
k
u
o
o
a
l
w
"}
(14,1,1) = {"
w
l
l
a
a
o
k
X
o
o
k
p
o
k
k
o
o
o
o
o
o
o
o
o
p
o
o
a
l
w
"}
(15,1,1) = {"
w
l
l
a
a
o
o
p
o
o
o
o
o
p
k
p
d
o
o
o
p
k
o
o
o
o
o
a
l
w
"}
(16,1,1) = {"
w
l
l
a
a
a
o
o
o
o
o
o
o
o
o
o
o
u
o
o
o
o
o
o
o
o
o
a
l
w
"}
(17,1,1) = {"
w
l
l
a
a
a
a
o
o
o
k
p
o
o
o
o
o
o
k
k
o
o
o
X
o
o
o
a
l
w
"}
(18,1,1) = {"
w
l
l
l
a
a
a
o
o
o
o
k
k
k
o
o
p
o
o
o
u
o
o
o
o
o
o
a
l
w
"}
(19,1,1) = {"
w
l
l
l
a
a
o
o
k
k
o
o
k
p
o
k
k
o
o
o
k
o
o
o
o
o
a
a
l
w
"}
(20,1,1) = {"
w
l
l
l
a
a
o
o
p
o
o
o
d
o
o
k
p
o
o
e
d
o
k
o
o
o
a
a
l
w
"}
(21,1,1) = {"
w
l
l
l
a
o
o
o
o
o
u
o
o
o
o
o
o
o
o
o
o
o
k
o
o
o
a
a
l
w
"}
(22,1,1) = {"
w
l
l
l
a
o
o
o
e
o
o
o
p
k
o
e
o
o
o
o
o
o
o
o
o
o
a
l
l
w
"}
(23,1,1) = {"
w
l
l
l
a
o
o
o
p
o
o
p
o
o
o
p
o
o
o
o
o
o
o
o
o
o
a
l
l
w
"}
(24,1,1) = {"
w
l
l
l
a
a
o
o
o
o
k
X
o
o
k
u
k
o
o
o
o
o
o
o
o
a
a
l
l
w
"}
(25,1,1) = {"
w
l
l
l
a
a
a
o
o
o
o
o
o
o
o
o
o
o
o
o
o
o
o
o
o
a
a
l
l
w
"}
(26,1,1) = {"
w
l
l
l
a
a
a
a
o
o
o
o
o
o
o
o
o
o
a
a
a
o
o
o
a
a
l
l
l
w
"}
(27,1,1) = {"
w
l
l
l
l
a
a
a
a
a
a
o
o
o
o
o
a
a
a
a
a
a
a
a
a
a
l
l
l
w
"}
(28,1,1) = {"
w
l
l
l
l
l
l
a
a
a
a
a
a
a
a
a
a
a
l
l
a
a
a
a
l
l
l
l
l
w
"}
(29,1,1) = {"
w
l
l
l
l
l
l
l
l
l
l
l
l
l
l
l
l
l
l
l
l
l
l
l
l
l
l
l
l
w
"}
(30,1,1) = {"
w
w
w
w
w
w
w
w
w
w
w
w
w
w
w
w
w
w
w
w
w
w
w
w
w
w
w
w
w
w
"}
