//MAP CONVERTED BY dmm2tgm.py THIS HEADER COMMENT PREVENTS RECONVERSION, DO NOT REMOVE
"a" = (
/turf/simulated/mineral/floor/ignore_cavegen/turfpack/muriki,
/area/mine/explored/muriki/cave/deepdark)
"p" = (
/obj/structure/prop/rock,
/turf/simulated/mineral/floor/ignore_cavegen/turfpack/muriki,
/area/mine/explored/muriki/cave/deepdark)
"t" = (
/obj/structure/prop/rock/flat,
/turf/simulated/mineral/floor/ignore_cavegen/turfpack/muriki,
/area/mine/explored/muriki/cave/deepdark)
"u" = (
/turf/template_noop,
/area/mine/explored/muriki/cave/deepdark)
"z" = (
/obj/structure/prop/statue/pillar,
/turf/simulated/floor/outdoors/sidewalk/turfpack/muriki{
	icon_state = "slab"
	},
/area/mine/explored/muriki/cave/deepdark)
"E" = (
/obj/structure/prop/statue/angel,
/turf/simulated/floor/outdoors/sidewalk/turfpack/muriki{
	icon_state = "slab"
	},
/area/mine/explored/muriki/cave/deepdark)
"F" = (
/mob/living/simple_mob/ysbryd,
/obj/effect/decal/godray,
/obj/effect/rune,
/turf/simulated/floor/outdoors/sidewalk/turfpack/muriki{
	icon_state = "slab"
	},
/area/mine/explored/muriki/cave/deepdark)
"H" = (
/obj/structure/flora/rocks1,
/turf/simulated/mineral/floor/ignore_cavegen/turfpack/muriki,
/area/mine/explored/muriki/cave/deepdark)
"N" = (
/turf/template_noop,
/area/template_noop)
"Q" = (
/turf/simulated/floor/outdoors/sidewalk/turfpack/muriki{
	icon_state = "slab"
	},
/area/mine/explored/muriki/cave/deepdark)
"Z" = (
/obj/structure/flora/rocks2,
/turf/simulated/mineral/floor/ignore_cavegen/turfpack/muriki,
/area/mine/explored/muriki/cave/deepdark)

(1,1,1) = {"
N
N
N
N
N
N
N
N
N
N
N
N
N
N
N
N
N
N
N
N
"}
(2,1,1) = {"
N
N
N
N
u
u
t
a
a
u
N
N
N
u
a
a
Z
u
N
N
"}
(3,1,1) = {"
N
N
u
a
Z
a
a
Q
a
a
a
a
a
a
a
Q
a
p
N
N
"}
(4,1,1) = {"
N
u
u
a
a
Q
Q
a
a
a
t
Q
H
a
Q
a
a
a
u
N
"}
(5,1,1) = {"
N
u
a
a
a
z
a
a
Q
a
Z
a
a
p
Q
z
Q
a
a
N
"}
(6,1,1) = {"
N
u
a
Q
p
a
a
Q
p
Q
Q
Q
a
Q
Q
Q
a
Q
a
N
"}
(7,1,1) = {"
N
u
a
a
a
Q
a
Q
Q
Q
Q
Q
Q
a
Q
a
Q
a
u
N
"}
(8,1,1) = {"
N
u
a
a
Q
a
Q
Q
z
Q
Q
Q
z
Q
a
Q
p
a
u
N
"}
(9,1,1) = {"
N
N
u
a
a
a
Q
Q
Q
Q
Q
Q
Q
Q
a
a
a
u
N
N
"}
(10,1,1) = {"
N
N
u
a
Z
a
Q
Q
Q
E
F
Q
Q
Q
a
a
a
u
N
N
"}
(11,1,1) = {"
N
N
u
a
a
H
Q
Q
Q
Q
Q
Q
Q
Q
a
Q
H
a
u
N
"}
(12,1,1) = {"
N
u
u
t
a
a
Q
Q
z
Q
Q
Q
z
Q
Q
a
a
a
u
N
"}
(13,1,1) = {"
N
u
a
a
a
a
a
Q
Q
Q
Q
Q
Q
a
Q
a
a
a
p
N
"}
(14,1,1) = {"
N
u
a
Q
a
Q
a
a
Q
a
a
Q
a
a
a
Q
a
Q
a
N
"}
(15,1,1) = {"
N
u
a
a
a
z
p
a
a
Q
a
a
a
Q
Q
z
a
a
u
N
"}
(16,1,1) = {"
N
u
a
a
a
a
Q
a
a
a
a
Q
H
a
Q
a
Q
p
u
N
"}
(17,1,1) = {"
N
u
a
a
Q
t
a
a
a
Q
a
p
Q
a
a
Q
a
Q
N
N
"}
(18,1,1) = {"
N
N
u
a
a
a
Q
a
Z
a
a
a
a
a
Q
Z
a
u
N
N
"}
(19,1,1) = {"
N
N
N
u
a
a
a
a
u
N
N
u
a
t
a
a
u
N
N
N
"}
(20,1,1) = {"
N
N
N
N
N
N
N
N
N
N
N
N
N
N
N
N
N
N
N
N
"}
