//MAP CONVERTED BY dmm2tgm.py THIS HEADER COMMENT PREVENTS RECONVERSION, DO NOT REMOVE
"a" = (
/turf/simulated/floor/wood/turfpack/muriki,
/area/mine/explored/muriki/cave/deepdark)
"b" = (
/obj/effect/auto_crayon{
	icon_state = "air"
	},
/turf/simulated/floor/wood/broken/turfpack/muriki,
/area/mine/explored/muriki/cave/deepdark)
"c" = (
/obj/structure/simple_door/wood,
/turf/simulated/floor/wood/broken/turfpack/muriki,
/area/mine/explored/muriki/cave/deepdark)
"d" = (
/turf/simulated/wall/stonelogs/turfpack/muriki,
/area/mine/explored/muriki/cave/deepdark)
"h" = (
/obj/effect/landmark/bslocker,
/turf/simulated/floor/wood/turfpack/muriki,
/area/mine/explored/muriki/cave/deepdark)
"j" = (
/turf/simulated/mineral/alt/turfpack/muriki,
/area/mine/explored/muriki/cave/deepdark)
"n" = (
/obj/structure/table/rack,
/obj/item/suit_cooling_unit,
/obj/item/suit_cooling_unit,
/turf/simulated/floor/wood/turfpack/muriki,
/area/mine/explored/muriki/cave/deepdark)
"q" = (
/obj/machinery/space_heater,
/turf/simulated/floor/wood/turfpack/muriki,
/area/mine/explored/muriki/cave/deepdark)
"r" = (
/turf/simulated/floor/wood/broken/turfpack/muriki,
/area/mine/explored/muriki/cave/deepdark)
"t" = (
/turf/template_noop,
/area/template_noop)
"w" = (
/obj/structure/table/rack,
/obj/item/storage/pouch/flares/full_glow,
/obj/item/suit_cooling_unit,
/obj/item/gps/mining,
/obj/item/tank/jetpack/carbondioxide,
/obj/item/clothing/shoes/magboots,
/obj/item/clothing/mask/breath,
/obj/item/tank/air,
/obj/item/clothing/suit/space/void/mining,
/obj/item/clothing/head/helmet/space/void/mining,
/turf/simulated/floor/wood/broken/turfpack/muriki,
/area/mine/explored/muriki/cave/deepdark)
"z" = (
/obj/structure/table/rack/shelf/wood,
/obj/item/clothing/suit/space/void/medical,
/obj/item/clothing/suit/space/void/medical,
/obj/item/clothing/head/helmet/space/void/medical,
/obj/item/clothing/head/helmet/space/void/medical,
/obj/item/gps/medical,
/obj/item/gps/medical,
/turf/simulated/floor/wood/turfpack/muriki,
/area/mine/explored/muriki/cave/deepdark)
"C" = (
/obj/structure/table/rack/shelf/wood,
/obj/item/tank/jetpack/oxygen,
/obj/item/tank/jetpack/oxygen,
/obj/item/tank/oxygen,
/obj/item/tank/oxygen,
/turf/simulated/floor/wood/turfpack/muriki,
/area/mine/explored/muriki/cave/deepdark)
"F" = (
/obj/machinery/light/small{
	dir = 1
	},
/obj/structure/table/rack/shelf/wood,
/obj/item/clothing/suit/space/void/security,
/obj/item/clothing/suit/space/void/security,
/obj/item/clothing/head/helmet/space/void/security,
/obj/item/clothing/head/helmet/space/void/security,
/obj/item/gps/security,
/obj/item/gps/security,
/obj/item/clothing/mask/breath,
/obj/item/clothing/mask/breath,
/obj/item/pickaxe,
/turf/simulated/floor/wood/turfpack/muriki,
/area/mine/explored/muriki/cave/deepdark)
"Q" = (
/obj/machinery/light/small,
/obj/item/clothing/shoes/magboots,
/obj/item/clothing/shoes/magboots,
/obj/item/clothing/shoes/magboots,
/obj/item/clothing/shoes/magboots,
/obj/structure/table/rack,
/turf/simulated/floor/wood/turfpack/muriki,
/area/mine/explored/muriki/cave/deepdark)
"U" = (
/turf/template_noop,
/area/mine/unexplored/muriki/cave/deepdark)
"Z" = (
/turf/simulated/mineral/floor/ignore_cavegen/turfpack/muriki,
/area/mine/explored/muriki/cave/deepdark)

(1,1,1) = {"
t
t
t
t
t
t
t
t
t
t
t
t
"}
(2,1,1) = {"
t
U
U
U
U
U
U
U
U
U
U
t
"}
(3,1,1) = {"
t
U
U
d
d
d
d
d
d
d
U
t
"}
(4,1,1) = {"
t
U
j
d
C
a
h
b
w
d
j
t
"}
(5,1,1) = {"
t
j
j
d
z
r
r
a
n
d
j
t
"}
(6,1,1) = {"
t
j
j
d
F
a
q
r
Q
d
j
t
"}
(7,1,1) = {"
t
j
j
d
d
d
d
c
d
d
j
t
"}
(8,1,1) = {"
t
j
j
Z
Z
Z
Z
Z
Z
j
j
t
"}
(9,1,1) = {"
t
U
Z
Z
Z
Z
Z
Z
Z
Z
Z
t
"}
(10,1,1) = {"
t
U
U
Z
Z
Z
Z
Z
Z
Z
U
t
"}
(11,1,1) = {"
t
U
U
U
U
U
U
U
U
U
U
t
"}
(12,1,1) = {"
t
t
t
t
t
t
t
t
t
t
t
t
"}
